022222222222220
20000000000000
20111111111111
20111111111111
20111111111111
20111111111111
20111111111111
20111111111111
20111111111111
20111111111111
20111111111111
20111111111111
20111111111111
20111111111111
20111111111111
00111111111111